....................
....................
....................
.......S............
.........S..........
..........MM........
...........M........
....................
........MMMMMM......
....................
.S..M...........M...
.S..............M...
.S....SSSS..........
.S..................
...MMMM.............
..........FFFFF.....
..FFFFFFFFFF..FFF...
....................
....................
....................