....................
....................
....................
.......S............
.........S..........
..........MM........
...........M........
....................
........MMMMMM......
....................
.S..M...........M...
.S..............M...
.S....SSSS..........
.S..................
...MMMM.............
..........FFFFF.....
..FFFFFFFFFF..FFF...
....................
....................
....................

START_POSITIONS
10,10
1,3
5,9
17,7
6,18
10,16
3,5
12,6